111111111111111111111111111
100000030001110001111000041
101110111101110101111013111
101010110100110101000010111
101010110110000103011100111
101000300110110111111101111
101101110110110000001000001
101101110110111111111011101
101100000010001000000001301
100010111111110110111101011
101110110001110110103101011
101000300001110110101101111
101110111100000300001100001
101110111101110111111101101
100002000000010100000101101
110110111111010101111101101
110110100000010000000001101
110110110111011111011111101
110110000111010011010030001
110110111111011011011111101
110110111111011011000000001
110111111111011011111110101
110111111101011000000000101
110111111100011011000011101
110300000001111011111111101
111111111103000011110030001
111111111111111111111111111