11111111111111111111111111111
10111300111211101101000114111
13111110111000000100011110111
10111110111011110301111110111
10000000000011110111111110111
11110111111111100000000000111
11110111100000001111110111111
13010111101111111111110111111
11010110001111111111110111111
11010111101111111113000111111
11000101101111300000110111111
10011100001111111110010111111
10111110111111111110110111111
10000000011111111110110111111
11111111011111111110110111111
11111111000000000000000111111
11111111101111111111011111111
11100003001110111111011111111
11111111100000111111000031111
11111111111111111111111111111
